  Adam Shamir does the subjects: Triple Science - Physics, Triple Science - Chemistry, Triple Science - Biology, Malay, Geography, Computer Science
  Adele Chin does the subjects: Triple Science - Physics, Triple Science - Chemistry, Triple Science - Biology, French, Business, DT Product
  Adishwar Sundaresan does the subjects: French, Geography, Business, DT Product
  Adithya Shamir does the subjects: Triple Science - Physics, Triple Science - Chemistry, Triple Science - Biology, French, History, Drama
  Aiden Kimmitt does the subjects: French, Geography, DT Product, Computer Science
  Aiman Shahrul Bahri does the subjects: Malay, Business, Geography
  Aisyah Musib does the subjects: French, Business, History, Art
  Aisyah Ya'akob does the subjects: Malay, Geography, Art, DT Product
  Aizat Mohd Yunos does the subjects: History, Malay, Art, Business
  Akma Alzam Noor Azman does the subjects: Malay, Geography, ICT, DT Product
  Aldric Lim does the subjects: Malay, Business, Economics, DT Food
  Aliah Adzlan does the subjects: Triple Science - Physics, Triple Science - Chemistry, Triple Science - Biology, Malay, Geography, History
  Alisha Shahromey does the subjects: Ad Maths, Malay, History, Business, Geography
  Ameerah Amirul does the subjects: History, Malay, Art, Business
  Amiera Besecker does the subjects: Triple Science - Physics, Triple Science - Chemistry, Triple Science - Biology, Spanish, Business, Media Studies
  Amit Dawn does the subjects: Triple Science - Physics, Triple Science - Chemistry, Triple Science - Biology, Geography, ICT
  Anaqi Arsahrin does the subjects: Malay, Geography
  Anaqin Mohammad Shamsul does the subjects: History, Malay, Art, DT Product
  Anesya Shaiful Rizal does the subjects: Economics, Malay, Art, Geography
  Anusha Bhushan does the subjects: Triple Science - Physics, Triple Science - Chemistry, Triple Science - Biology, Ad Maths, French, Art, Economics
  Anushka Pandey does the subjects: Triple Science - Physics, Triple Science - Chemistry, Triple Science - Biology, French, Business, Geography
  Aqil Zulkhairi does the subjects: Malay, Business, DT Product, Geography
  Ariff Shahrin does the subjects: Malay, Art, Geography, DT Food
  Asadullah Abbasi does the subjects: Triple Science - Physics, Triple Science - Chemistry, Triple Science - Biology, French, History, Economics
  Athena Chalmers does the subjects: French, History, Art, Drama
  Atip Adimas does the subjects: Triple Science - Physics, Triple Science - Chemistry, Triple Science - Biology, Ad Maths, Economics, Malay, Computer Science
  Basit Al Hassan does the subjects: Malay, Art, Drama, Geography
  Bazil Osmali does the subjects: Triple Science - Physics, Triple Science - Chemistry, Triple Science - Biology, Economics, Malay, History
  Bruno Ribeiro does the subjects: Triple Science - Physics, Triple Science - Chemistry, Triple Science - Biology, French, Geography, Drama
  Charley Grimshaw does the subjects: Spanish, Art, Media Studies, Drama
  Cheryl Kong does the subjects: Triple Science - Physics, Triple Science - Chemistry, Triple Science - Biology, History, Chinese, DT Food
  Chi Phan does the subjects: Spanish, Art, Economics, DT Product
  Chloe Hill does the subjects: Triple Science - Physics, Triple Science - Chemistry, Triple Science - Biology, French, History, DT Product
  Claudia Vegas Castro does the subjects: Spanish, Art, Geography, Drama
  Daniaa Shahirul Shaimee does the subjects: Malay, Geography, Media Studies, Business
  Danial Suhaini does the subjects: Triple Science - Physics, Triple Science - Chemistry, Triple Science - Biology, Malay, History
  Daniel Sim does the subjects: Malay, Business, History
  Darwish Zainal does the subjects: Triple Science - Physics, Triple Science - Chemistry, Triple Science - Biology, Ad Maths, Economics, Malay, Computer Science
  Diyatha Premaratne does the subjects: Triple Science - Physics, Triple Science - Chemistry, Triple Science - Biology, Ad Maths, French, Geography, DT Product
  Eauel Alba does the subjects: Triple Science - Physics, Triple Science - Chemistry, Triple Science - Biology, Spanish, History, Art
  Eleanor Bell does the subjects: Spanish, Business, Media Studies, History
  Eleanor Briffa does the subjects: French, History, Art, DT Product
  Elhan Khairul Anwar does the subjects: Computer Science, Malay, DT Product, History
  Elysha Lien does the subjects: Spanish, Art, Media Studies, History
  Enya Hua does the subjects: History, Chinese, Business, Art
  Ethan Officer does the subjects: Economics, Malay, Drama, Geography
  Ethan Wong does the subjects: Triple Science - Physics, Triple Science - Chemistry, Triple Science - Biology, History, Malay, Economics
  Evie Page does the subjects: Spanish, Chinese, DT Product, History
  Faatimah Rahman does the subjects: Malay, Art, Media Studies, Business
  Faiq Rizam does the subjects: Triple Science - Physics, Triple Science - Chemistry, Triple Science - Biology, Ad Maths, Malay, Music, Computer Science
  Farah Lutfi does the subjects: Economics, Malay, Drama, History
  Fathin Aiadi does the subjects: Triple Science - Physics, Triple Science - Chemistry, Triple Science - Biology, Malay, Art, Computer Science
  Fatin Kassim does the subjects: Triple Science - Physics, Triple Science - Chemistry, Triple Science - Biology, Malay, Art, Business
  Filippa Baur does the subjects: Triple Science - Physics, Triple Science - Chemistry, Triple Science - Biology, French, History, Art
  Finn Wotton does the subjects: French, Geography, DT Product
  Gabriel Chan does the subjects: Triple Science - Physics, Triple Science - Chemistry, Triple Science - Biology, Ad Maths, Malay, DT Product, Computer Science
  Gilby Sheridan does the subjects: Triple Science - Physics, Triple Science - Chemistry, Triple Science - Biology, French, Art, DT Product
  Grayden Savidan does the subjects: French, Business, DT Product, History
  Gwendolyn Tong does the subjects: Computer Science, Chinese, Media Studies, Business
  Hakim Osmera does the subjects: Malay, Geography, Media Studies, DT Food
  Hani Seffry does the subjects: Economics, Malay, Media Studies, Art
  Haziq Aziz does the subjects: Malay, History, DT Product, Business
  Hong Zhu Chua does the subjects: Malay, History, Economics, Geography
  Hridyansh Tichkule does the subjects: Triple Science - Physics, Triple Science - Chemistry, Triple Science - Biology, French, Media Studies, Drama
  Humaira Maiddin does the subjects: Economics, Malay, Geography, DT Food
  Iffah Jamsari does the subjects: Spanish, History, Drama, Art
  Iffah Yusri does the subjects: Triple Science - Physics, Triple Science - Chemistry, Triple Science - Biology, Ad Maths, Malay, Business, Art
  Isaac Dullah does the subjects: Triple Science - Physics, Triple Science - Chemistry, Triple Science - Biology, Malay, Art, Geography
  Ishba Amir does the subjects: Triple Science - Physics, Triple Science - Chemistry, Triple Science - Biology, French, Geography, Economics
  James Bannister does the subjects: French, History, Drama
  Jasmeen Rahman does the subjects: Economics, Malay, Art, Geography
  Jasmin Amirrudin does the subjects: History, Malay, Media Studies, Art
  Jia Wei Ang does the subjects: Malay, Chinese, Media Studies, Drama
  Jillian Fernandes does the subjects: Spanish, Art, Economics, DT Product
  Jolin Goh does the subjects: Triple Science - Physics, Triple Science - Chemistry, Triple Science - Biology, Chinese, Geography, Business
  Josh Lindsay does the subjects: Triple Science - Physics, Triple Science - Chemistry, Triple Science - Biology, Ad Maths, French, Geography, Computer Science
  Juan Granados Garcia does the subjects: Triple Science - Physics, Triple Science - Chemistry, Triple Science - Biology, French, Drama, History
  Jun Heng Tan does the subjects: Triple Science - Physics, Triple Science - Chemistry, Triple Science - Biology, Economics, Malay, DT Product
  Justin Lim does the subjects: Triple Science - Physics, Triple Science - Chemistry, Triple Science - Biology, Ad Maths, Economics, Malay, Art
  Kartikeya Aneja does the subjects: Triple Science - Physics, Triple Science - Chemistry, Triple Science - Biology, Ad Maths, Computer Science, Chinese, Business
  Kate Edgeler does the subjects: French, Music, Media Studies, History
  Kelly Lim does the subjects: Triple Science - Physics, Triple Science - Chemistry, Triple Science - Biology, Ad Maths, French, Geography, Art
  Kester Pacudan does the subjects: Triple Science - Physics, Triple Science - Chemistry, Triple Science - Biology, French, Geography, Drama
  Kiefer Lim does the subjects: Triple Science - Physics, Triple Science - Chemistry, Triple Science - Biology, Ad Maths, Malay, Media Studies, Computer Science
  Kimberley Goh does the subjects: Triple Science - Physics, Triple Science - Chemistry, Triple Science - Biology, French, Business, DT Food
  Le Phan does the subjects: Spanish, Business, DT Product, Geography
  Lili Woodard does the subjects: Ad Maths, Spanish, History, Economics, Drama
  Liyana Glenn does the subjects: Triple Science - Physics, Triple Science - Chemistry, Triple Science - Biology, Malay, History, DT Food
  Liz James does the subjects: Triple Science - Physics, Triple Science - Chemistry, Triple Science - Biology, French, Geography, Art
  Louise Gurmin does the subjects: Triple Science - Physics, Triple Science - Chemistry, Triple Science - Biology, French, History, Art
  Luke Conway does the subjects: French, History, Art, Drama
  Manahil Chughtai does the subjects: Triple Science - Physics, Triple Science - Chemistry, Triple Science - Biology, French, Economics, Geography
  Mansi Rao does the subjects: Triple Science - Physics, Triple Science - Chemistry, Triple Science - Biology, French, Art, Economics
  Marjorie Wong does the subjects: Triple Science - Physics, Triple Science - Chemistry, Triple Science - Biology, Economics, Chinese, Geography
  Marsya Idris does the subjects: Triple Science - Physics, Triple Science - Chemistry, Triple Science - Biology, Malay, History, DT Product
  Max Page does the subjects: Triple Science - Physics, Triple Science - Chemistry, Triple Science - Biology, Spanish, Business, History
  Maxine Brown does the subjects: French, Business, History
  Michele Deelen does the subjects: History, Chinese, Media Studies, Art
  Michelle Chong does the subjects: Triple Science - Physics, Triple Science - Chemistry, Triple Science - Biology, Malay, Geography, Art
  Mirza Roslie does the subjects: Triple Science - Physics, Triple Science - Chemistry, Triple Science - Biology, Malay, History, Geography
  Miza Athaa'ullah does the subjects: Triple Science - Physics, Triple Science - Chemistry, Triple Science - Biology, Malay, History, Drama
  Muhammad Qaiser does the subjects: Triple Science - Physics, Triple Science - Chemistry, Triple Science - Biology, French, History, Economics
  Muhammad Zulaidi does the subjects: Economics, Malay, ICT, History
  Muizzah Naaim does the subjects: Malay, History, Art
  Mustafa Nasir does the subjects: Triple Science - Physics, Triple Science - Chemistry, Triple Science - Biology, Ad Maths, Chinese, DT Product, Geography
  Nabeel Jufri does the subjects: Malay, Art, Geography, DT Product
  Nadhrah Melhan does the subjects: Malay, Geography, Media Studies, Art
  Nadya Rozaiman does the subjects: Triple Science - Physics, Triple Science - Chemistry, Triple Science - Biology, Ad Maths, Malay, History, Business
  Naim Elmi does the subjects: Malay, Geography, DT Product, Business
  Naomi Carter does the subjects: Spanish, History, Drama
  Naomi Lau does the subjects: Triple Science - Physics, Triple Science - Chemistry, Triple Science - Biology, Chinese, Art, DT Product
  Natalie Fowler does the subjects: French, Business, Geography, DT Product
  Natalie Sia does the subjects: French, Business, History
  Nathan Gibbs does the subjects: Triple Science - Physics, Triple Science - Chemistry, Triple Science - Biology, French, Geography, DT Product
  Nathazsha Gande does the subjects: Triple Science - Physics, Triple Science - Chemistry, Triple Science - Biology, Music, Art, Business
  Nazarah Marshall does the subjects: French, Art, Media Studies, Drama
  Nick Bourbon does the subjects: French, Art, Drama, History
  Nur Hasdiny does the subjects: History, Malay, Business, Art
  Nurin Adi Ihram does the subjects: Economics, Malay, Media Studies, History
  Omar Sufri does the subjects: Triple Science - Physics, Triple Science - Chemistry, Triple Science - Biology, Malay, Geography, DT Food
  Otto Wiseman does the subjects: French, Art, Media Studies, History
  Penang Tamang does the subjects: Triple Science - Physics, Triple Science - Chemistry, Triple Science - Biology, Computer Science, Chinese
  Rafeeqa Teo does the subjects: Triple Science - Physics, Triple Science - Chemistry, Triple Science - Biology, Spanish, Art, History
  Rafiq Azmi does the subjects: Triple Science - Physics, Triple Science - Chemistry, Triple Science - Biology, Malay, Business, History
  Raihan Sani does the subjects: Triple Science - Physics, Triple Science - Chemistry, Triple Science - Biology, Malay, Art, Geography
  Rania Albadii Shahnoel does the subjects: Malay, Geography, History, Business
  Rania Zamhadi does the subjects: History, Malay, Media Studies, Business
  Rasy Khairol Asmiee does the subjects: Triple Science - Physics, Triple Science - Chemistry, Triple Science - Biology, Economics, Malay, Art
  Rauf Rosli does the subjects: Malay, Geography, History, DT Food
  Ray Kakuta does the subjects: Triple Science - Physics, Triple Science - Chemistry, Triple Science - Biology, Ad Maths, Spanish, Economics, Computer Science
  Rayyan Yusdiman does the subjects: Triple Science - Physics, Triple Science - Chemistry, Triple Science - Biology, Economics, Malay, Geography
  Rebecca Yahya does the subjects: French, History, Geography, Drama
  Ridwan Iqbal does the subjects: Computer Science, Chinese, History, Geography
  Ruey Chan does the subjects: Triple Science - Physics, Triple Science - Chemistry, Triple Science - Biology, Malay, Business, Computer Science
  Safwanah Malik does the subjects: Malay, Art, Media Studies, History
  Samuel Boulanger does the subjects: French, Art, Media Studies, Drama
  Sarah Doreen Seagrave does the subjects: French, Geography, Economics, History
  Sarah Reizal does the subjects: Malay, Geography, Art, DT Product
  Shahmi Shamsul does the subjects: Economics, Malay, ICT, Geography
  Shahnaz Rahman does the subjects: Malay, Geography, Economics, History
  Sheharyar Siddiqui does the subjects: Triple Science - Physics, Triple Science - Chemistry, Triple Science - Biology, French, Geography, Computer Science
  Skye Xu does the subjects: Art, Economics, DT Product
  Syafi Suraini does the subjects: Malay, Geography, DT Product, Art
  Syaheedah Sazali does the subjects: Triple Science - Physics, Triple Science - Chemistry, Triple Science - Biology, History, Malay, Art
  Syasya Ismawi does the subjects: Malay, Music, Economics, Geography
  Syura Samir does the subjects: Malay, Art, Media Studies, Business
  Tiana Moore does the subjects: Ad Maths, Spanish, Chinese, Economics, Art
  Tom Granville does the subjects: French, History, Geography, Drama
  Tyler Ang does the subjects: Computer Science, Malay, Economics, Geography
  Umair Nafees does the subjects: Triple Science - Physics, Triple Science - Chemistry, Triple Science - Biology, Malay, Geography, ICT
  Uzma Khairuddin does the subjects: Economics, Malay, Art, Geography
  Wafiyyah Ahmad Baihaki does the subjects: Malay, Art, Media Studies, Geography
  Warith Moss does the subjects: Triple Science - Physics, Triple Science - Chemistry, Triple Science - Biology, Computer Science, Malay, DT Product
  Xun Ling does the subjects: Triple Science - Physics, Triple Science - Chemistry, Triple Science - Biology, Ad Maths, Economics, Chinese, Geography
  Yadi Ariffin does the subjects: Triple Science - Physics, Triple Science - Chemistry, Triple Science - Biology, Malay, Art, DT Food
  Zahra Sufri does the subjects: Triple Science - Physics, Triple Science - Chemistry, Triple Science - Biology, Malay, Art, Business
  Zhi Min Lim does the subjects: Triple Science - Physics, Triple Science - Chemistry, Triple Science - Biology, Ad Maths, Chinese, Art, Geography
  Ziyan Li does the subjects: Chinese, Economics
  Zuyyin Malik does the subjects: Triple Science - Physics, Triple Science - Chemistry, Triple Science - Biology, Malay, Business, Geography